111111
1E0C01
110001
10CJP1
111111
